乳腺癌	乳癌
保法止	柔沛
倍美力	普力馬林
優思明	悅己
卵泡刺激素	濾泡刺激素
垂體促性腺激素	性腺激素釋放素
天生女性	原生女性
性腺性激素	性腺激素
抗雄激素	抗雄性素
比卡魯胺	可蘇多
激光	雷射
脫靶活動	脫靶效應
色譜龍	安得卡
螺內酯	蘇拉通
補佳樂	益斯德
達芙通	得胎隆
適尿通	新髮靈
高血鉀癥	高血鉀症
睾酮	睪固酮
藥物	藥品
數據  資料
紅細胞  紅血球
片劑  錠劑
總體  總和